<level width="320" height="240">
  <Solids exportMode="Bitstring">11111111111111111111
11111111111111111111
10000011110000000001
10000011110000000001
10000011110111110001
10000011110111110001
10000000000111110001
10000000000111110001
11110000000111110001
11110000000000110001
11110000111110110001
11111111111110110001
11111111111110110001
11111111111110000001
11111111111111111111</Solids>
  <Background tileset="City" exportMode="CSV">0,1,0,0,11,11,10,10,10,10,10,10,10,10,10,10,10,10,10,10
1,0,1,1,11,11,10,10,10,10,10,10,10,10,10,10,10,10,10,10
10,26,26,26,26,26,11,11,10,10,26,26,26,26,26,26,26,26,26,10
10,26,26,26,26,26,10,10,10,10,26,26,26,26,26,26,26,26,26,10
10,26,26,26,26,26,10,10,11,11,26,10,10,10,10,10,26,26,26,10
10,26,26,26,26,26,10,10,10,11,26,10,10,10,10,10,26,26,26,10
10,26,26,26,26,26,26,26,26,26,26,10,10,10,10,10,26,26,26,10
10,26,26,26,26,26,26,26,26,26,26,10,10,10,10,10,26,26,26,56
10,10,10,10,26,26,26,26,26,26,26,10,10,10,10,10,26,26,26,10
10,10,10,10,26,26,26,26,26,26,26,26,26,26,10,10,26,26,26,10
10,10,10,10,26,26,26,26,10,10,10,10,10,26,10,10,26,26,26,10
10,10,10,10,10,10,10,10,10,10,10,10,10,26,10,10,26,26,26,10
10,10,10,10,10,10,10,10,10,10,10,10,10,26,10,10,26,26,26,10
10,10,10,10,10,10,10,10,10,10,10,10,10,26,26,26,26,26,26,10
10,10,10,10,10,10,10,10,10,10,10,10,10,10,10,10,10,10,10,10</Background>
  <Foreground tileset="City" exportMode="XMLCoords" />
  <Objects>
    <Player id="0" x="32" y="32" />
    <Exit id="1" x="304" y="112" />
  </Objects>
</level>